TruSeq_Universal_Adapter	AATGATACGGCGACCACCGAGATCTACACTCTTTCCCTACACGACGCTCTTCCGATCT
TruSeq_Adapter_Index_1	GATCGGAAGAGCACACGTCTGAACTCCAGTCACATCACGATCTCGTATGCCGTCTTCTGCTTG
TruSeq_Adapter_Index_2	GATCGGAAGAGCACACGTCTGAACTCCAGTCACCGATGTATCTCGTATGCCGTCTTCTGCTTG
TruSeq_Adapter_Index_3	GATCGGAAGAGCACACGTCTGAACTCCAGTCACTTAGGCATCTCGTATGCCGTCTTCTGCTTG
TruSeq_Adapter_Index_4	GATCGGAAGAGCACACGTCTGAACTCCAGTCACTGACCAATCTCGTATGCCGTCTTCTGCTTG
TruSeq_Adapter_Index_5	GATCGGAAGAGCACACGTCTGAACTCCAGTCACACAGTGATCTCGTATGCCGTCTTCTGCTTG
TruSeq_Adapter_Index_6	GATCGGAAGAGCACACGTCTGAACTCCAGTCACGCCAATATCTCGTATGCCGTCTTCTGCTTG
TruSeq_Adapter_Index_7	GATCGGAAGAGCACACGTCTGAACTCCAGTCACCAGATCATCTCGTATGCCGTCTTCTGCTTG
TruSeq_Adapter_Index_8	GATCGGAAGAGCACACGTCTGAACTCCAGTCACACTTGAATCTCGTATGCCGTCTTCTGCTTG
TruSeq_Adapter_Index_9	GATCGGAAGAGCACACGTCTGAACTCCAGTCACGATCAGATCTCGTATGCCGTCTTCTGCTTG
TruSeq_Adapter_Index_10	GATCGGAAGAGCACACGTCTGAACTCCAGTCACTAGCTTATCTCGTATGCCGTCTTCTGCTTG
TruSeq_Adapter_Index_11	GATCGGAAGAGCACACGTCTGAACTCCAGTCACGGCTACATCTCGTATGCCGTCTTCTGCTTG
TruSeq_Adapter_Index_12	GATCGGAAGAGCACACGTCTGAACTCCAGTCACCTTGTAATCTCGTATGCCGTCTTCTGCTTG
TruSeq_Adapter_Index_13	GATCGGAAGAGCACACGTCTGAACTCCAGTCACAGTCAACAATCTCGTATGCCGTCTTCTGCTTG
TruSeq_Adapter_Index_14	GATCGGAAGAGCACACGTCTGAACTCCAGTCACAGTTCCGTATCTCGTATGCCGTCTTCTGCTTG
TruSeq_Adapter_Index_15	GATCGGAAGAGCACACGTCTGAACTCCAGTCACATGTCAGAATCTCGTATGCCGTCTTCTGCTTG
TruSeq_Adapter_Index_16	GATCGGAAGAGCACACGTCTGAACTCCAGTCACCCGTCCCGATCTCGTATGCCGTCTTCTGCTTG
TruSeq_Adapter_Index_18	GATCGGAAGAGCACACGTCTGAACTCCAGTCACGTCCGCACATCTCGTATGCCGTCTTCTGCTTG
TruSeq_Adapter_Index_19	GATCGGAAGAGCACACGTCTGAACTCCAGTCACGTGAAACGATCTCGTATGCCGTCTTCTGCTTG
TruSeq_Adapter_Index_20	GATCGGAAGAGCACACGTCTGAACTCCAGTCACGTGGCCTTATCTCGTATGCCGTCTTCTGCTTG
TruSeq_Adapter_Index_21	GATCGGAAGAGCACACGTCTGAACTCCAGTCACGTTTCGGAATCTCGTATGCCGTCTTCTGCTTG
TruSeq_Adapter_Index_22	GATCGGAAGAGCACACGTCTGAACTCCAGTCACCGTACGTAATCTCGTATGCCGTCTTCTGCTTG
TruSeq_Adapter_Index_23	GATCGGAAGAGCACACGTCTGAACTCCAGTCACGAGTGGATATCTCGTATGCCGTCTTCTGCTTG
TruSeq_Adapter_Index_25	GATCGGAAGAGCACACGTCTGAACTCCAGTCACACTGATATATCTCGTATGCCGTCTTCTGCTTG
TruSeq_Adapter_Index_27	GATCGGAAGAGCACACGTCTGAACTCCAGTCACATTCCTTTATCTCGTATGCCGTCTTCTGCTTG
Illumina_Multiplexing_Adapter_1	GATCGGAAGAGCACACGTCT
Illumina_Multiplexing_Adapter_2	ACACTCTTTCCCTACACGACGCTCTTCCGATCT
Illumina_Multiplexing_PCR_Primer_1.01	AATGATACGGCGACCACCGAGATCTACACTCTTTCCCTACACGACGCTCTTCCGATCT
Illumina_Multiplexing_PCR_Primer_2.01	GTGACTGGAGTTCAGACGTGTGCTCTTCCGATCT
Illumina_Multiplexing_Read1_Sequencing_Primer	ACACTCTTTCCCTACACGACGCTCTTCCGATCT
Illumina_Multiplexing_Index_Sequencing_Primer	GATCGGAAGAGCACACGTCTGAACTCCAGTCAC
Illumina_Multiplexing_Read2_Sequencing_Primer	GTGACTGGAGTTCAGACGTGTGCTCTTCCGATCT
nextera_adapter	CTGTCTCTTATACACATCT
nextera_transposase_seq_read1	TCGTCGGCAGCGTCAGATGTGTATAAGAGACAG
nextera_transposase_seq_read2	GTCTCGTGGGCTCGGAGATGTGTATAAGAGACAG
pacbio	AAGCAGTGGTATCAACGCAGAGTAC

#adapters for ccbr647,648 Vanderweele

indexed_adapter_index_1|ACAGTG|CACTGT	CAAGCAGAAGACGGCATACGAGATCACTGTGTGACTGGAGTTCAGACGTGTGCTCTTCCGATC
indexed_adapter_rc_index_1|ACAGTG|CACTGT	GATCGGAAGAGCACACGTCTGAACTCCAGTCACACAGTGATCTCGTATGCCGTCTTCTGCTTG
indexed_adapter_index_2|ACTTGA|TCAAGT	CAAGCAGAAGACGGCATACGAGATTCAAGTGTGACTGGAGTTCAGACGTGTGCTCTTCCGATC
indexed_adapter_rc_index_2|ACTTGA|TCAAGT	GATCGGAAGAGCACACGTCTGAACTCCAGTCACACTTGAATCTCGTATGCCGTCTTCTGCTTG
indexed_adapter_index_3|AGTCAA|TTGACT	CAAGCAGAAGACGGCATACGAGATTTGACTGTGACTGGAGTTCAGACGTGTGCTCTTCCGATC
indexed_adapter_rc_index_3|AGTCAA|TTGACT	GATCGGAAGAGCACACGTCTGAACTCCAGTCACAGTCAAATCTCGTATGCCGTCTTCTGCTTG
indexed_adapter_index_4|AGTTCC|GGAACT	CAAGCAGAAGACGGCATACGAGATGGAACTGTGACTGGAGTTCAGACGTGTGCTCTTCCGATC
indexed_adapter_rc_index_4|AGTTCC|GGAACT	GATCGGAAGAGCACACGTCTGAACTCCAGTCACAGTTCCATCTCGTATGCCGTCTTCTGCTTG
indexed_adapter_index_5|ATCACG|CGTGAT	CAAGCAGAAGACGGCATACGAGATCGTGATGTGACTGGAGTTCAGACGTGTGCTCTTCCGATC
indexed_adapter_rc_index_5|ATCACG|CGTGAT	GATCGGAAGAGCACACGTCTGAACTCCAGTCACATCACGATCTCGTATGCCGTCTTCTGCTTG
indexed_adapter_index_6|ATGTCA|TGACAT	CAAGCAGAAGACGGCATACGAGATTGACATGTGACTGGAGTTCAGACGTGTGCTCTTCCGATC
indexed_adapter_rc_index_6|ATGTCA|TGACAT	GATCGGAAGAGCACACGTCTGAACTCCAGTCACATGTCAATCTCGTATGCCGTCTTCTGCTTG
indexed_adapter_index_7|CAGATC|GATCTG	CAAGCAGAAGACGGCATACGAGATGATCTGGTGACTGGAGTTCAGACGTGTGCTCTTCCGATC
indexed_adapter_rc_index_7|CAGATC|GATCTG	GATCGGAAGAGCACACGTCTGAACTCCAGTCACCAGATCATCTCGTATGCCGTCTTCTGCTTG
indexed_adapter_index_8|CCGTCC|GGACGG	CAAGCAGAAGACGGCATACGAGATGGACGGGTGACTGGAGTTCAGACGTGTGCTCTTCCGATC
indexed_adapter_rc_index_8|CCGTCC|GGACGG	GATCGGAAGAGCACACGTCTGAACTCCAGTCACCCGTCCATCTCGTATGCCGTCTTCTGCTTG
indexed_adapter_index_9|CGATGT|ACATCG	CAAGCAGAAGACGGCATACGAGATACATCGGTGACTGGAGTTCAGACGTGTGCTCTTCCGATC
indexed_adapter_rc_index_9|CGATGT|ACATCG	GATCGGAAGAGCACACGTCTGAACTCCAGTCACCGATGTATCTCGTATGCCGTCTTCTGCTTG
indexed_adapter_index_10|CTTGTA|TACAAG	CAAGCAGAAGACGGCATACGAGATTACAAGGTGACTGGAGTTCAGACGTGTGCTCTTCCGATC
indexed_adapter_rc_index_10|CTTGTA|TACAAG	GATCGGAAGAGCACACGTCTGAACTCCAGTCACCTTGTAATCTCGTATGCCGTCTTCTGCTTG
indexed_adapter_index_11|GATCAG|CTGATC	CAAGCAGAAGACGGCATACGAGATCTGATCGTGACTGGAGTTCAGACGTGTGCTCTTCCGATC
indexed_adapter_rc_index_11|GATCAG|CTGATC	GATCGGAAGAGCACACGTCTGAACTCCAGTCACGATCAGATCTCGTATGCCGTCTTCTGCTTG
indexed_adapter_index_12|GCCAAT|ATTGGC	CAAGCAGAAGACGGCATACGAGATATTGGCGTGACTGGAGTTCAGACGTGTGCTCTTCCGATC
indexed_adapter_rc_index_12|GCCAAT|ATTGGC	GATCGGAAGAGCACACGTCTGAACTCCAGTCACGCCAATATCTCGTATGCCGTCTTCTGCTTG
indexed_adapter_index_13|GGCTAC|GTAGCC	CAAGCAGAAGACGGCATACGAGATGTAGCCGTGACTGGAGTTCAGACGTGTGCTCTTCCGATC
indexed_adapter_rc_index_13|GGCTAC|GTAGCC	GATCGGAAGAGCACACGTCTGAACTCCAGTCACGGCTACATCTCGTATGCCGTCTTCTGCTTG
indexed_adapter_index_14|GTCCGC|GCGGAC	CAAGCAGAAGACGGCATACGAGATGCGGACGTGACTGGAGTTCAGACGTGTGCTCTTCCGATC
indexed_adapter_rc_index_14|GTCCGC|GCGGAC	GATCGGAAGAGCACACGTCTGAACTCCAGTCACGTCCGCATCTCGTATGCCGTCTTCTGCTTG
indexed_adapter_index_15|GTGAAA|TTTCAC	CAAGCAGAAGACGGCATACGAGATTTTCACGTGACTGGAGTTCAGACGTGTGCTCTTCCGATC
indexed_adapter_rc_index_15|GTGAAA|TTTCAC	GATCGGAAGAGCACACGTCTGAACTCCAGTCACGTGAAAATCTCGTATGCCGTCTTCTGCTTG
indexed_adapter_index_16|GTGGCC|GGCCAC	CAAGCAGAAGACGGCATACGAGATGGCCACGTGACTGGAGTTCAGACGTGTGCTCTTCCGATC
indexed_adapter_rc_index_16|GTGGCC|GGCCAC	GATCGGAAGAGCACACGTCTGAACTCCAGTCACGTGGCCATCTCGTATGCCGTCTTCTGCTTG
indexed_adapter_index_17|GTTTCG|CGAAAC	CAAGCAGAAGACGGCATACGAGATCGAAACGTGACTGGAGTTCAGACGTGTGCTCTTCCGATC
indexed_adapter_rc_index_17|GTTTCG|CGAAAC	GATCGGAAGAGCACACGTCTGAACTCCAGTCACGTTTCGATCTCGTATGCCGTCTTCTGCTTG
indexed_adapter_index_18|TAGCTT|AAGCTA	CAAGCAGAAGACGGCATACGAGATAAGCTAGTGACTGGAGTTCAGACGTGTGCTCTTCCGATC
indexed_adapter_rc_index_18|TAGCTT|AAGCTA	GATCGGAAGAGCACACGTCTGAACTCCAGTCACTAGCTTATCTCGTATGCCGTCTTCTGCTTG
indexed_adapter_index_19|TGACCA|TGGTCA	CAAGCAGAAGACGGCATACGAGATTGGTCAGTGACTGGAGTTCAGACGTGTGCTCTTCCGATC
indexed_adapter_rc_index_19|TGACCA|TGGTCA	GATCGGAAGAGCACACGTCTGAACTCCAGTCACTGACCAATCTCGTATGCCGTCTTCTGCTTG
indexed_adapter_index_20|TTAGGC|GCCTAA	CAAGCAGAAGACGGCATACGAGATGCCTAAGTGACTGGAGTTCAGACGTGTGCTCTTCCGATC
indexed_adapter_rc_index_20|TTAGGC|GCCTAA	GATCGGAAGAGCACACGTCTGAACTCCAGTCACTTAGGCATCTCGTATGCCGTCTTCTGCTTG
